1111111111111
1111111111111
1EEE111EEEEE1
1EEE1P1EEEEE1
1EEE1C1EEEEE1
1EEE111EEEEE1
1111111111111
