1111111111
1P110001E1
1011010101
1011010101
1C11C10101
10000100C1
1111111111
