11111111111111111111111111111111111111111111111111111111111111
10000000000000000000000000000000000000000000000000000000000001
10000000000000000000000100000000000000000000000000000000000001
1000000000000000000000010000000000000C000000000000000000000001
100000000000000000000001000000C0000000000000000000000000000001
10000000000000000000000100000000000000000000C00000000000000001
10000000000000000000000100000000000000000000000000000000000001
10000000000000000000000100000000000000000000000000000000000001
10000000000000000000000100000000000000000000000000000000000001
10000000000000000000000100000C00000000000000000000000000000001
100000000000000000000001000000000000000C0000000000000000000001
10000000000000000000000100000000000000000000000000000000000001
111111010100000000000001000000000000000000000C0000000000000001
10000000000000000000000100000000000000000000000000000000000001
10000EP00000000000000001000000000C0000000000000000000000000001
11111111111111111111111111111111111111111111111111111111111111
